111111111111111
100C0000C0000C1
100000C0000P001
100001111110001
1000000C0000001
1000C0000C000C1
100000000000001
111111111111111