111111111111111
1E0C1000C0000C1
100001C0000P001
100001000000001
1000001C0000001
1000C0011C000C1
100000000100001
111111111111111