111111111111111
1CEC0000C000PC1
111111111111111