111111111111111
1PEC0000C0000C1
111111111111111