111111111111111
1PEC0000C0000C1
100100000000001
100100000000001
1C0100000000001
111111111111111