111111111111111
1E0C0000C0000P1
111111111111111